####################
#S..#..............#
#.#.#.############.#
#.#.#.#..K...t...#.#
#.#...#.#.######.#.#
#.#####%#.#....#.#.#
#.......#.#.##.#.#.#
#.#######.#.##.%.#.#
#.#...M...#.##...#.#
#...#######.#####G##
#####.......#......#
#.....#######.####.#
#.###.#.......#....#
#.#.#.#.#######.##.#
#.#.#...#.......#..#
#.#.#####.#####.#..#
#.#.......#...#.#..#
#F#########.#.#.#..#
#T...F......#...#F.#
####################